Haverford
An Interactive Fiction by Rich Rutenberg Haverford Station is a room
Release 1 / Serial number 190121 / Inform 7 build 6M62 (I6/v6.33 lib 6/12N) SD

Haverford Station
The train stops and the conductor yells Haverford. You make your way off the train to the platform and watch the train depart into the distance.

You can see a train here.

>look train
The train is going going going. gone.

>look train
The train is going going going. gone.

>w
Station Road
You are at station road. There is a park to the west. The station is to the east. A sign pointing south says RT 30. The road continue up to the north where you can see a massive stone wall with a wrought iron fence.

>n
Cricket Club
Engraved in the entrance of the wall to the grounds reads M C C. A burly man guards the entrance to the property.

You can see a guard here.

>n
You can't go that way.

>w
You can't go that way.

>e
You can't go that way.

>s
Station Road
You are at station road. There is a park to the west. The station is to the east. A sign pointing south says RT 30. The road continue up to the north where you can see a massive stone wall with a wrought iron fence.

>s
Route 30
Route 30 is an old trading route that runs from Philadelphia to Lancaster. There are several closed shopping centers with overpriced coffee and designer clothing. You can make out a sign to the west in the distance that glows BAR.

>s
You can't go that way.

>s
You can't go that way.

* * *

Haverford
An Interactive Fiction by Rich Rutenberg Haverford Station is a room
Release 1 / Serial number 190121 / Inform 7 build 6M62 (I6/v6.33 lib 6/12N) SD

Haverford Station
The train stops and the conductor yells Haverford. You make your way off the train to the platform and watch the train depart into the distance.

You can see a train here.

>q
Are you sure you want to quit?

* * *

>w
Station Road
You are at station road. There is a park to the west. The station is to the east. A sign pointing south says RT 30. The road continue up to the north where you can see a massive stone wall with a wrought iron fence.

>s
Route 30
Route 30 is an old trading route that runs from Philadelphia to Lancaster. There are several closed shopping centers with overpriced coffee and designer clothing. You can make out a sign to the west in the distance that glows BAR.

* * *

>s
You can't go that way.

>e
Guard Station
The banner on the wall says, Welcome to Haverford College. The little house is where the campus safety oficer sits when there are events.  Nobody is here now.

I beg your pardon?

>e
You can't go that way.

>s
Duck Pond
This is a wonderful place with a pond filled with turtles and fish. There are families of ducks swimming in the pond. 

You can see Sign and Ducks here.

>look
Duck Pond
This is a wonderful place with a pond filled with turtles and fish. There are families of ducks swimming in the pond. 

You can see Sign and Ducks here.

>get sign
Taken.

>get ducks
Taken.

>s
You can't go that way.

* * *

Haverford
An Interactive Fiction by Rich Rutenberg Haverford Station is a room
Release 1 / Serial number 190121 / Inform 7 build 6M62 (I6/v6.33 lib 6/12N) SD

Haverford Station
The train stops and the conductor yells Haverford. You make your way off the train to the platform and watch the train depart into the distance.

You can see a train here.

>w
Station Road
You are at station road. There is a park to the west. The station is to the east. A sign pointing south says RT 30. The road continue up to the north where you can see a massive stone wall with a wrought iron fence.

* * *

>s
Route 30
Route 30 is an old trading route that runs from Philadelphia to Lancaster. There are several closed shopping centers with overpriced coffee and designer clothing. You can make out a sign to the west in the distance that glows BAR.

>e
Guard Station
The banner on the wall says, Welcome to Haverford College. The little house is where the campus safety oficer sits when there are events.  Nobody is here now.

>e
You can't go that way.

* * *

>s
Duck Pond
This is a wonderful place with a pond filled with turtles and fish. There are families of ducks swimming in the pond. 

You can see Sign and Ducks here.

>look sign
Wooden sign reading No Ice Skating.

* * *

>e
Guard Station
The banner on the wall says, Welcome to Haverford College. The little house is where the campus safety oficer sits when there are events.  Nobody is here now.

>get Ducks
Taken.

>look Ducks
There are Mr. and Mrs. Mallard, and their children Jack, Kack, Lack, Mack, Nack, Ouack, Pack, and Quack .

>eat ducks
That's plainly inedible.

* * *

>e
Guard Station
The banner on the wall says, Welcome to Haverford College. The little house is where the campus safety oficer sits when there are events.  Nobody is here now.

>s
Duck Pond
This is a wonderful place with a pond filled with turtles and fish. There are families of ducks swimming in the pond. 

You can see sign here.

>look
Duck Pond
This is a wonderful place with a pond filled with turtles and fish. There are families of ducks swimming in the pond. 

You can see sign here.

>get duck
You can't see any such thing.

>look duck
You can't see any such thing.

>get duck
You can't see any such thing.

>look
Duck Pond
This is a wonderful place with a pond filled with turtles and fish. There are families of ducks swimming in the pond. 

You can see sign here.

>get sign
Taken.

>look duck pond
You can't see any such thing.

>look
Duck Pond
This is a wonderful place with a pond filled with turtles and fish. There are families of ducks swimming in the pond.

>look ducks
There are Mr. and Mrs. Mallard, and their children Jack, Kack, Lack, Mack, Nack, Ouack, Pack, and Quack .

* * *

>s
Duck Pond
This is a wonderful place with a pond filled with turtles and fish. There are families of ducks swimming in the pond. 

You can see sign here.

>look duck
There are Mr. and Mrs. Mallard, and their children Jack, Kack, Lack, Mack, Nack, Ouack, Pack, and Quack .

>look ducks
There are Mr. and Mrs. Mallard, and their children Jack, Kack, Lack, Mack, Nack, Ouack, Pack, and Quack .

>loock duck family
That's not a verb I recognise.

>look duck family
There are Mr. and Mrs. Mallard, and their children Jack, Kack, Lack, Mack, Nack, Ouack, Pack, and Quack .

* * *

>s
Duck Pond
This is a wonderful place with a pond filled with turtles and fish. There are families of ducks swimming in the pond. 

You can see sign here.

>look ducks
There are Mr. and Mrs. Mallard, and their children Jack, Kack, Lack, Mack, Nack, Ouack, Pack, and Quack .

>e
Dead End
As you walk down this dusty path you pass several cedar homes that must have been constructed in the 1960s.  Off in the distance across a small creek at the bottom of the steep hill you can see the arched roof of the Skating Club.  Dead End.

>w
Duck Pond
This is a wonderful place with a pond filled with turtles and fish. There are families of ducks swimming in the pond. 

You can see sign and ducks here.

>s
You can't go that way.

>e
Dead End
As you walk down this dusty path you pass several cedar homes that must have been constructed in the 1960s.  Off in the distance across a small creek at the bottom of the steep hill you can see the arched roof of the Skating Club.  Dead End.

>e
You can't go that way.

>w
Duck Pond
This is a wonderful place with a pond filled with turtles and fish. There are families of ducks swimming in the pond. 

You can see sign and ducks here.

>w
You can't go that way.

>w
You can't go that way.

>s
You can't go that way.

* * *

>e
Guard Station
The banner on the wall says, Welcome to Haverford College. The little house is where the campus safety oficer sits when there are events.  Nobody is here now.

>s
Duck Pond
This is a wonderful place with a pond filled with turtles and fish. There are families of ducks swimming in the pond. 

You can see sign and ducks here.

>e
Dead End
As you walk down this dusty path you pass several cedar homes that must have been constructed in the 1960s.  Off in the distance across a small creek at the bottom of the steep hill you can see the arched roof of the Skating Club.  Dead End.

* * *

>w
Duck Pond
This is a wonderful place with a pond filled with turtles and fish. There are families of ducks swimming in the pond. 

You can see sign and ducks here.

>s
College Circle
As you look around the cirlce you count 6 gray stone buildings.  They must have been here at least a hundred years.  One has a beautiful wrap around porch.  That must be the President's house.

>s
You can't go that way.

>w
You can't go that way.

* * *

>e
You can't go that way.

>n
Duck Pond
This is a wonderful place with a pond filled with turtles and fish. There are families of ducks swimming in the pond. 

You can see sign and ducks here.

>n
Guard Station
The banner on the wall says, Welcome to Haverford College. The little house is where the campus safety oficer sits when there are events.  Nobody is here now.

* * *

>s
Route 30
Route 30 is an old trading route that runs from Philadelphia to Lancaster. There are several closed shopping centers with overpriced coffee and designer clothing. You can make out a sign to the west in the distance that glows BAR.

>w
Roache Bar
You wander up the street hypnotized by the sign and find yourself inside an old bar. The bartender comes over and says, should I make it a double Rick James? You play along and say sure, don't I always. As the bartender pours you a double shot of tequila you look up and notice an Oscar trophy on a shelf behind the bar.  To the north there are some boothes, and there is a phone booth in the northeast corner of the room. The bathroom enterence is southwest.

I have my eye on you Rick James. The bartender says as he makes his way into the basement cellar.

You can also see Oscar and Tequila here.

>get oscar
Taken.

>go grille
You can't see any such thing.

>go n
You can't go that way.

>go w
You can't go that way.

>go s
Kitchen
You quietly get up and sprint into the Kitchen. You slip as you try to stop yourself but luckily regain your balance. As you get up something catches your eye under the grill on the north end the Kitchen.

>get bacon
You can't see any such thing.

>look
Kitchen
You quietly get up and sprint into the Kitchen. You slip as you try to stop yourself but luckily regain your balance. As you get up something catches your eye under the grill on the north end the Kitchen.

>n
Roache Bar
You wander up the street hypnotized by the sign and find yourself inside an old bar. The bartender comes over and says, should I make it a double Rick James? You play along and say sure, don't I always. As the bartender pours you a double shot of tequila you look up and notice an Oscar trophy on a shelf behind the bar.

I have my eye on you Rick James. The bartender says as he makes his way into the basement cellar.

You can also see Tequila here.

>get tequila
Taken.

>s
Kitchen
You quietly get up and sprint into the Kitchen. You slip as you try to stop yourself but luckily regain your balance. As you get up something catches your eye under the grill on the north end the Kitchen.

>s
You can't go that way.

>w
Grille
You are at the north end of the kitchen by the grill.

You can see Bacon here.

>get bacon
Taken.

>e
Kitchen
You quietly get up and sprint into the Kitchen. You slip as you try to stop yourself but luckily regain your balance. As you get up something catches your eye under the grill on the north end the Kitchen.

>n
Roache Bar
You wander up the street hypnotized by the sign and find yourself inside an old bar. The bartender comes over and says, should I make it a double Rick James? You play along and say sure, don't I always. As the bartender pours you a double shot of tequila you look up and notice an Oscar trophy on a shelf behind the bar.

I have my eye on you Rick James. The bartender says as he makes his way into the basement cellar.

>e
Route 30
Route 30 is an old trading route that runs from Philadelphia to Lancaster. There are several closed shopping centers with overpriced coffee and designer clothing. You can make out a sign to the west in the distance that glows BAR.

>e
Duck Pond
This is a wonderful place with a pond filled with turtles and fish. There are families of ducks swimming in the pond. 

You can see Sign here.

>read sign
Wooden sign reading No Ice Skating.

>feed ducks
You can't see any such thing.

>eat bacon
That's plainly inedible.

>look bacon
Crispy, Crunchy, Wonderful Bacon!

>look
Duck Pond
This is a wonderful place with a pond filled with turtles and fish. There are families of ducks swimming in the pond. 

You can see Sign here.

>get sign
Taken.

>look sign
Wooden sign reading No Ice Skating.

>inventory
You are carrying:
  Sign
  Bacon
  Tequila
  Oscar

>feed duck
You can't see any such thing.

* * *

>n
You can't go that way.

* * *

>w
You can't go that way.

>s
Kitchen
You quietly get up and sprint into the Kitchen. You slip as you try to stop yourself but luckily regain your balance. As you get up something catches your eye under the grill on the north end the Kitchen.

* * *

>s
You can't go that way.

>n
Roache Bar
You wander up the street hypnotized by the sign and find yourself inside an old bar. The bartender comes over and says, should I make it a double Rick James? You play along and say sure, don't I always. As the bartender pours you a double shot of tequila you look up and notice an Oscar trophy on a shelf behind the bar.  To the north there are some boothes, and there is a phone booth in the northeast corner of the room. The bathroom enterence is southwest.

I have my eye on you Rick James. The bartender says as he makes his way into the basement cellar.

You can also see Oscar and Tequila here.

>w
You can't go that way.

* * *

>s
Kitchen
You quietly get up and sprint into the Kitchen. You slip as you try to stop yourself but luckily regain your balance. As you get up something catches your eye under the grill on the north end the Kitchen.

>e
You can't go that way.

>s
You can't go that way.

* * *

>sw
You can't go that way.

>ne
Phone Booth

>sw
Roache Bar
You wander up the street hypnotized by the sign and find yourself inside an old bar. The bartender comes over and says, should I make it a double Rick James? You play along and say sure, don't I always. As the bartender pours you a double shot of tequila you look up and notice an Oscar trophy on a shelf behind the bar.  To the north there are some boothes, and there is a phone booth in the northeast corner of the room. The bathroom enterence is southwest.

I have my eye on you Rick James. The bartender says as he makes his way into the basement cellar.

You can also see Oscar and Tequila here.

>n
You can't go that way.

* * *

>sw
You can't go that way.

* * *

>sw
Roache Bar
You wander up the street hypnotized by the sign and find yourself inside an old bar. The bartender comes over and says, should I make it a double Rick James? You play along and say sure, don't I always. As the bartender pours you a double shot of tequila you look up and notice an Oscar trophy on a shelf behind the bar.

I have my eye on you Rick James. The bartender says as he makes his way into the basement cellar.

You can also see Oscar and Tequila here.

* * *

>sw
You can't go that way.

>se
Phone Booth

* * *

>make call
That's not a verb I recognise.

>call
That's not a verb I recognise.

>get phone
That seems to be a part of the phone booth.

>get handset
You can't see any such thing.

>take handset
You can't see any such thing.

>take phone
That seems to be a part of the phone booth.

>rub base
You rub the phone base.

>rub slot
You idly buff it with your hand, but nothing happens. The grime seems to have set in.

>look slot
The quarter slot is surrounded by a layer of grime.

>w
You can't go that way.

* * *

>e
You can't go that way.

>n
You can't go that way.

>s
You can't go that way.

>exit
But you aren't in anything at the moment.

>wheere am i
That's not a verb I recognise.

>look
You are in a phone booth, trying to look inconspicuous. You are holding the handset, the cord dangling between you and the base on the wall.

>leave
But you aren't in anything at the moment.

>hang up
That's not a verb I recognise.

>call
That's not a verb I recognise.

* * *

>w
Station Road
You are at station road. There is a park to the west. The station is to the east. A sign pointing south says RT 30. The road continue up to the north where you can see a massive stone wall with a wrought iron fence.

>w
The Sharpe Bird Sanctuary
You are in the bird park. Attached to a tree is a sign that reads: No Dogs, No Smoking, No Camping.

>s
You can't go that way.

>e
Station Road
You are at station road. There is a park to the west. The station is to the east. A sign pointing south says RT 30. The road continue up to the north where you can see a massive stone wall with a wrought iron fence.

>s
Route 30
Route 30 is an old trading route that runs from Philadelphia to Lancaster. There are several closed shopping centers with overpriced coffee and designer clothing. You can make out a sign to the west in the distance that glows BAR.

>w
Roache Bar
You wander up the street hypnotized by the sign and find yourself inside an old bar. The bartender comes over and says, should I make it a double Rick James? You play along and say sure, don't I always. As the bartender pours you a double shot of tequila you look up and notice an Oscar trophy on a shelf behind the bar.  There is a phone booth in the Northeast corner of the room.

I have my eye on you Rick James. The bartender says as he makes his way into the basement cellar.

You can also see Oscar and Tequila here.

>ne
Phone Booth

* * *

>look phone
The base of the phone is grimy and sticky. The quarter slot is surrounded by a layer of grime, and the coin return flap is rusted.

>look flap
The coin return flap is empty.

>look grime
The quarter slot is surrounded by a layer of grime.

>shine slot
You idly buff it with your hand, but nothing happens. The grime seems to have set in.

>ne
You can't go that way.

>sw
Roache Bar
You wander up the street hypnotized by the sign and find yourself inside an old bar. The bartender comes over and says, should I make it a double Rick James? You play along and say sure, don't I always. As the bartender pours you a double shot of tequila you look up and notice an Oscar trophy on a shelf behind the bar.  There is a phone booth in the Northeast corner of the room.

I have my eye on you Rick James. The bartender says as he makes his way into the basement cellar.

You can also see Oscar and Tequila here.